11111111
11111011
1P000001
1C000C01
1C00C101
111111E1
11111111
