111111
1CP001
1111E1
100C01
100001
111111