111111
10P001
111101
a00001
1C01E1
111111
