111111
1CP001
111101
100C01
1000E1
a
111111
