1111111
1C0P001
1111101
1000001
1000001
100C001
1000001
1111101
1000101
10011E1
1111111
