1111111
1CP0CC1
11111E1
1CCCCC1
1CCCCC1
1C1C1C1
1CC1CC1
1111111
10001C01
1111111
