1111111
1C0P001
1111101
1000001
1000001
101E101
1001001
1111101
1000101
1001101
1111111
