1111111
1CPCCC1
1CCCCC1
1CCCCC1
1CCCCC1
1C1C1C1
1CC1CC1
1111CC1
1ECCCC1
1111111
