1111111
10P1E01
1E11CC1
1111111
