11111111
10000001
1a0000001
11111111
