1111111
1C0P001
11111E1
1000001
1000001
100C001
1000001
1111101
1000101
1001101
1111111
