1111111
10P0001
100C001
100C001
1000001
1010101
1001001
1111CC1
1E00001
1111111
