1111111
1C0P001
1111101
1000001
1000001
100C001
1000001
1111101
10001E1
1001101
1111111